30,520,60,520
111111111111111111111111111111
16             1            71 
1              1             1
11111PPPP111111111111MMMM11111
1                            1
1                            1
1    11111          111111   1
1                            1
1                            1
1    1555555555555555555555511
1   1                        1
1                            1
1                            1
1                            1
111112211331122113311221     1
1                       1    1
1                            1
1                            1
1                            1
111144111111144111111144111111