420,280,480,280
Bilder/Background_clouds.jpeg
111111111111111111111111111111
1                            1 
1                            1
1                            1
1                            1
1                            1
1                            1
1            GGGGG           1
1            G   G           1
1            G   G           1
1            G g G           1
1            11111           1
1        GG         GG       1
1                            1
1     GG               GG    1
1                            1
1   GG                   GG  1
1                            1
16g                        g71
111111444444444444444444411111