330,40,540,40
Bilder/Background.jpeg
111111111111111111111111111111
1             11             1
1            7116            1
1         1111111111         1
1    11111    11             1
1             11    11       1
1             11             1
1 111111111   11             1
1             11      11     1
1             11             1
1          11 11             1
1             11   11        1
1             11             1
1      11     11             1
1             1111           1
1             11             1
1   11        11   1111111   1
              11              
              11              
111144444444441144444444441111