840,520,30,520
111111111111111111111111111111
1                            1
1                            1
1                            1
1                            1
1                            1
1                            1
1                            1
1                            1
1                            1
1                            1
1                            1
1                            1
1                            1
16                          71
1                            1
111111                  111111
1                            1
1                            1
111111111111111111111111111111