395,100,475,100
OOOOOOOOOOOOOOOOOOOOOOOOOOOOOO
111111111111111111111111111111
1OOOOOOOOOOOOOOOOOOOOOOOOOOOO1
1OOOOOOOOOOOOOOOOOOOOOOOOOOOO1
1OOOOOOOOOOOOOOOOOOOOOOOOOOOO1
1OOOOOOOOOOOOOOOOOOOOOOOOOOOO1
1OOOOOOOOOOOOOOOOOOOOOOOOOOOO1
111111111111111111115555555111
OOOOOOOOOOOOOOOOOOOOOOOOOOOOOO
OOOOOOOOOOOOOOOOOOOOOOOOOOOOOO
OOOOOOOOOOOOOOOOOOOOOOOOOOOOOO
OOOOOOOOOOOOOOOOOOOOOOOOOOOOOO
OOOOOOOOOOOOOOOOOOOOOOOOOOOOOO
OOOOOOOOOOOOOOOOOOOOOOOOOOOOOO
OOOOOOOOOOOOOOOOOOOOOOOOOOOOOO
OOOOOOOOOOOOOOOOOOOOOOOOOOOOOO
OOOOOOOOOOOOOOOOOOOOOOOOOOOOOO
OOOOOOOOOOOOOOOOOOOOOOOOOOOOOO
OOOOOOOOOOOOOOOOOOOOOOOOOOOOOO
OOOOOOOOOOOOOOOOOOOOOOOOOOOOOO
