700,520,100,520
Bilder/Background.jpeg
111111111111111111111111111111
1                            1
1                            1
1                            1
1                            1
1                            1
16                          71
1111                      1111
1                            1
1                            1
11111113311        11221111111
1                            1
1             111            1
1                            1
1                            1
1         11111111111        1
1                            1
1                            1
1                            1
111111111111111111111111111111