820,520,30,520
Bilder/Background.jpeg
111111111111111111111111111111
1                            1 
1                            1
16                          71
111                        111
1    11                11    1
1                            1
1        11        11        1
1                            1
1                            1
1            1111            1
1                            1
1        111      111        1
1                            1
1     11              11     1
1                            1
1  11                    11  1
1                            1
1                            1
133333311114444444411112222221