700,520,100,520
111111111111111111111111111111
1                            1
1                            1
1                            1
1                            1
1                            1
1                            1
1                            1
16                          71
1                        r   1
111111M1111        111P1111111
1                            1
1            11L11           1
1                            1
1                            1
1         111R111G111        1
1                            1
1                            1
1                            1
111111111111111111111111111111