30,520,60,520
Bilder/Background.jpeg
111111111111111111111111111111
1                            1 
1                            1
1                            1
1                            1
1                            1
1            l   r   g       1
1           11111111111      1
1                            1
1                            1
1                            1
1                            1
1                            1
1                            1
1                            1
1                            1
1                            1
1                            1
1            l    r   g      1
111111111111111111111111111111