0,0,0,0
Bilder/Background.png
111111111111111111111111111111
1                            1 
1                            1
1                            1
1                            1
1                            1
1                            1
1                            1
1                            1
1                            1
1                            1
1                            1
1                            1
1                            1
1                            1
1                            1
1                            1
1                            1
1                            1
111111111111111111111111111111