60,520,30,520
111111111111111111111111111  1
1        GGG      LLL        1 
1        GGG      LLL        1
1        GGG      LLL        1
16 g     GGG      LLL        1
1111     GGG      LLL        1
1        GGG      LLL        1
1        GGG      LLL        1
17       GGG g  l LLL l      1
111111111111111111111111444111
1                            1
1                            1
1                            1
1                            1
1                            1
1   1333331        1222221   1
1                            1
1                            1
1                            1
111112222211111111133333331  1