60,520,30,520
Bilder/Background.jpeg
111111111111111111111111111111
1                            1 
1                          761
1MM1PP111111111111111111111111
1                            1
1                            1
1                     g      1
1111111111111111111111111GGGG1
1                            1
1                            1
1      l        g            1
1LLLL1111111111111111111111111
1                            1
1                            1
1     l              g       1
1111111111111111111111111GGGG1
1                            1
1                            1
1                g           1
111111111111111111111111111111