840,520,30,520
111111111111111111111111111111
176                          1
1                            1
11111111              1      1
1      111         14111     1
1        11114411111         1
1                         1111
1                            1
1               1111         1
1            111    11  114441
1                            1
1                            1
1         1115555111         1
1                            1
1 1                        1 1
1   1222221        1333331   1
1                            1
1                            1
1                            1
112111111111221133111111111311