300,520,570,520
111111111111     1111111111111
1                            1 
1                            1
1                            1
1                            1
1                            1
1                            1
1                            1
1                            1
1                            1
1         RRRRRRRRRR         1
1                            1
1        144444444441        1
1                   1 RRR  l 1
1                   1     1111
1                   1        1
1LL                 1        1
1 L                 1        1
16L    r            1       71
111111111111     1111111111111