840,520,30,520
111111111111111111111111111111
176                          1
1                            1
11111111              1      1
1      111         11111     1
1        11111111111         1
1                         1111
1                            1
1               1111         1
1            111    11  111111
1                            1
1                            1
1         1111111111         1
1                            1
1 1                        1 1
1   1111111        1111111   1
1                            1
1                            1
1                            1
111111111111111111111111111111