700,520,100,520
1111111111111111111   11111111
1                            1
1                            1
1                            1
1                            1
1                            1
1                            1
1                            1
16                          71
1  g                     r   1
111111M1111        111R1111111
1                            1
1            11L11           1
1                            1
1              l             1
1         11RR111G11PPP11    1
1         R      L       G   1
1         R      L       G   1
1l g  r   R      L       G   1
111111111111111111111111111111